keyword	keyword Thesaurus
Carey Lab	carey lab controlled vocabulary
Virginia Tech	carey lab controlled vocabulary
Stream Team	carey lab controlled vocabulary
teaching	carey lab controlled vocabulary
macrosystems	carey lab controlled vocabulary
GLEON	carey lab controlled vocabulary
Suggs	carey lab controlled vocabulary
Barco	carey lab controlled vocabulary
Prairie Pothole	carey lab controlled vocabulary
Prairie Lake	carey lab controlled vocabulary
Little Rock Lake	carey lab controlled vocabulary
Crampton	carey lab controlled vocabulary
NEON	carey lab controlled vocabulary
Toolik	carey lab controlled vocabulary
National Ecological Observatory Network	carey lab controlled vocabulary
ecological forecasting	carey lab controlled vocabulary
near-term iterative ecological forecasting	carey lab controlled vocabulary
uncertainty	carey lab controlled vocabulary
lake	cuahsi controlled vocabulary
lakes	lter controlled vocabulary
modeling	lter controlled vocabulary
models	lter controlled vocabulary
productivity	lter controlled vocabulary
climate change	lter controlled vocabulary